1111111111
1010001111
1000000111
1011011111
1000000111
1101101111
1101100001
0001101011
0001101011
0001101011
1111111011
