1111111011111111
1000000000001111
1011111111101111
1111111111101111
1110000000001111
1110111111011111
1110111111011111
1110000000000011
1111110111111111
1110110000001111
1110111111101111
1110000000001111
1111111011111111
1000000000000011
1111110111111011
1111110111111111